[
  {
    "id": 1,
    "width": 4,
    "height": 4,
    "fixed": [
      { "x": 0, "y": 0, "value": 1 },
      { "x": 2, "y": 0, "value": 5 },
      { "x": 3, "y": 2, "value": 8 },
      { "x": 1, "y": 3, "value": 13 },
      { "x": 0, "y": 2, "value": 15 }
    ],
    "solution": [
      { "x": 0, "y": 0 },
      { "x": 1, "y": 0 },
      { "x": 1, "y": 1 },
      { "x": 2, "y": 1 },
      { "x": 2, "y": 0 },
      { "x": 3, "y": 0 },
      { "x": 3, "y": 1 },
      { "x": 3, "y": 2 },
      { "x": 3, "y": 3 },
      { "x": 2, "y": 3 },
      { "x": 2, "y": 2 },
      { "x": 1, "y": 2 },
      { "x": 1, "y": 3 },
      { "x": 0, "y": 3 },
      { "x": 0, "y": 2 },
      { "x": 0, "y": 1 }
    ]
  },

  {
    "id": 2,
    "width": 5,
    "height": 5,
    "fixed": [
      { "x": 2, "y": 0, "value": 1 },
      { "x": 2, "y": 1, "value": 6 },
      { "x": 0, "y": 2, "value": 11 },
      { "x": 2, "y": 3, "value": 18 },
      { "x": 4, "y": 4, "value": 21 },
      { "x": 4, "y": 0, "value": 25 }
    ],
    "solution": [
      { "x": 2, "y": 0 },
      { "x": 3, "y": 0 },
      { "x": 3, "y": 1 },
      { "x": 3, "y": 2 },
      { "x": 2, "y": 2 },
      { "x": 2, "y": 1 },
      { "x": 1, "y": 1 },
      { "x": 1, "y": 0 },
      { "x": 0, "y": 0 },
      { "x": 0, "y": 1 },
      { "x": 0, "y": 2 },
      { "x": 1, "y": 2 },
      { "x": 1, "y": 3 },
      { "x": 0, "y": 3 },
      { "x": 0, "y": 4 },
      { "x": 1, "y": 4 },
      { "x": 2, "y": 4 },
      { "x": 2, "y": 3 },
      { "x": 3, "y": 3 },
      { "x": 3, "y": 4 },
      { "x": 4, "y": 4 },
      { "x": 4, "y": 3 },
      { "x": 4, "y": 2 },
      { "x": 4, "y": 1 },
      { "x": 4, "y": 0 }
    ]
  },

  {
    "id": 3,
    "width": 6,
    "height": 6,
    "fixed": [
      { "x": 0, "y": 0, "value": 1 },
      { "x": 5, "y": 0, "value": 26 },
      { "x": 3, "y": 1, "value": 31 },
      { "x": 1, "y": 2, "value": 6 },
      { "x": 4, "y": 3, "value": 36 },
      { "x": 1, "y": 5, "value": 11 },
      { "x": 4, "y": 5, "value": 18 }
    ],

    "solution": [
      { "x": 0, "y": 0 },
      { "x": 1, "y": 0 },
      { "x": 1, "y": 1 },
      { "x": 0, "y": 1 },
      { "x": 0, "y": 2 },
      { "x": 1, "y": 2 },
      { "x": 1, "y": 3 },
      { "x": 0, "y": 3 },
      { "x": 0, "y": 4 },
      { "x": 0, "y": 5 },
      { "x": 1, "y": 5 },
      { "x": 1, "y": 4 },
      { "x": 2, "y": 4 },
      { "x": 2, "y": 5 },
      { "x": 3, "y": 5 },
      { "x": 3, "y": 4 },
      { "x": 4, "y": 4 },
      { "x": 4, "y": 5 },
      { "x": 5, "y": 5 },
      { "x": 5, "y": 4 },
      { "x": 5, "y": 3 },
      { "x": 5, "y": 2 },
      { "x": 4, "y": 2 },
      { "x": 4, "y": 1 },
      { "x": 5, "y": 1 },
      { "x": 5, "y": 0 },
      { "x": 4, "y": 0 },
      { "x": 3, "y": 0 },
      { "x": 2, "y": 0 },
      { "x": 2, "y": 1 },
      { "x": 3, "y": 1 },
      { "x": 3, "y": 2 },
      { "x": 2, "y": 2 },
      { "x": 2, "y": 3 },
      { "x": 3, "y": 3 },
      { "x": 4, "y": 3 }
    ]
  },

  {
    "id": 4,
    "width": 7,
    "height": 7,
    "fixed": [
      { "x": 6, "y": 0, "value": 1 },
      { "x": 2, "y": 1, "value": 6 },
      { "x": 5, "y": 1, "value": 49 },
      { "x": 0, "y": 3, "value": 12 },
      { "x": 2, "y": 3, "value": 24 },
      { "x": 4, "y": 4, "value": 37 },
      { "x": 0, "y": 6, "value": 29 },
      { "x": 5, "y": 6, "value": 40 }
    ],

    "solution": [
      { "x": 6, "y": 0 },
      { "x": 5, "y": 0 },
      { "x": 4, "y": 0 },
      { "x": 3, "y": 0 },
      { "x": 2, "y": 0 },
      { "x": 2, "y": 1 },
      { "x": 1, "y": 1 },
      { "x": 1, "y": 0 },
      { "x": 0, "y": 0 },
      { "x": 0, "y": 1 },
      { "x": 0, "y": 2 },
      { "x": 0, "y": 3 },
      { "x": 0, "y": 4 },
      { "x": 1, "y": 4 },
      { "x": 1, "y": 3 },
      { "x": 1, "y": 2 },
      { "x": 2, "y": 2 },
      { "x": 3, "y": 2 },
      { "x": 3, "y": 1 },
      { "x": 4, "y": 1 },
      { "x": 4, "y": 2 },
      { "x": 4, "y": 3 },
      { "x": 3, "y": 3 },
      { "x": 2, "y": 3 },
      { "x": 2, "y": 4 },
      { "x": 2, "y": 5 },
      { "x": 1, "y": 5 },
      { "x": 0, "y": 5 },
      { "x": 0, "y": 6 },
      { "x": 1, "y": 6 },
      { "x": 2, "y": 6 },
      { "x": 3, "y": 6 },
      { "x": 4, "y": 6 },
      { "x": 4, "y": 5 },
      { "x": 3, "y": 5 },
      { "x": 3, "y": 4 },
      { "x": 4, "y": 4 },
      { "x": 5, "y": 4 },
      { "x": 5, "y": 5 },
      { "x": 5, "y": 6 },
      { "x": 6, "y": 6 },
      { "x": 6, "y": 5 },
      { "x": 6, "y": 4 },
      { "x": 6, "y": 3 },
      { "x": 5, "y": 3 },
      { "x": 5, "y": 2 },
      { "x": 6, "y": 2 },
      { "x": 6, "y": 1 }
    ]
  },

  {
    "id": 5,
    "width": 8,
    "height": 8,
    "fixed": [
      { "x": 0, "y": 0, "value": 57 },
      { "x": 7, "y": 0, "value": 48 },
      { "x": 4, "y": 1, "value": 64 },
      { "x": 2, "y": 2, "value": 21 },
      { "x": 0, "y": 4, "value": 15 },
      { "x": 2, "y": 4, "value": 1 },
      { "x": 5, "y": 4, "value": 26 },
      { "x": 7, "y": 4, "value": 40 },
      { "x": 2, "y": 7, "value": 8 },
      { "x": 4, "y": 7, "value": 30 }
    ],

    "solution": [
      { "x": 2, "y": 4 },
      { "x": 3, "y": 4 },
      { "x": 3, "y": 5 },
      { "x": 2, "y": 5 },
      { "x": 2, "y": 6 },
      { "x": 3, "y": 6 },
      { "x": 3, "y": 7 },
      { "x": 2, "y": 7 },
      { "x": 1, "y": 7 },
      { "x": 0, "y": 7 },
      { "x": 0, "y": 6 },
      { "x": 1, "y": 6 },
      { "x": 1, "y": 5 },
      { "x": 0, "y": 5 },
      { "x": 0, "y": 4 },
      { "x": 1, "y": 4 },
      { "x": 1, "y": 3 },
      { "x": 0, "y": 3 },
      { "x": 0, "y": 2 },
      { "x": 1, "y": 2 },
      { "x": 2, "y": 2 },
      { "x": 2, "y": 3 },
      { "x": 3, "y": 3 },
      { "x": 4, "y": 3 },
      { "x": 4, "y": 4 },
      { "x": 5, "y": 4 },
      { "x": 5, "y": 5 },
      { "x": 4, "y": 5 },
      { "x": 4, "y": 6 },
      { "x": 4, "y": 7 },
      { "x": 5, "y": 7 },
      { "x": 5, "y": 6 },
      { "x": 6, "y": 6 },
      { "x": 6, "y": 7 },
      { "x": 7, "y": 7 },
      { "x": 7, "y": 6 },
      { "x": 7, "y": 5 },
      { "x": 6, "y": 5 },
      { "x": 6, "y": 4 },
      { "x": 7, "y": 4 },
      { "x": 7, "y": 3 },
      { "x": 6, "y": 3 },
      { "x": 5, "y": 3 },
      { "x": 5, "y": 2 },
      { "x": 6, "y": 2 },
      { "x": 7, "y": 2 },
      { "x": 7, "y": 1 },
      { "x": 7, "y": 0 },
      { "x": 6, "y": 0 },
      { "x": 6, "y": 1 },
      { "x": 5, "y": 1 },
      { "x": 5, "y": 0 },
      { "x": 4, "y": 0 },
      { "x": 3, "y": 0 },
      { "x": 2, "y": 0 },
      { "x": 1, "y": 0 },
      { "x": 0, "y": 0 },
      { "x": 0, "y": 1 },
      { "x": 1, "y": 1 },
      { "x": 2, "y": 1 },
      { "x": 3, "y": 1 },
      { "x": 3, "y": 2 },
      { "x": 4, "y": 2 },
      { "x": 4, "y": 1 }
    ]
  }
]
